NO textures/test/north.xpm
SO textures/test/south.xpm
WE textures/test/west.xpm
EA textures/test/east.xpm
F 120, 100, 80
C  30,  30, 30

1111111
1     1
1 1N1 1
1     1
1111111
