NO textures/test/north.xpm.
SO textures/test/south.xpm
WE textures/test/west.xpm
EA textures/test/east.xpm
F  12, 2, 255
C  15,  230, 33

1111111
1     1
1 1E1 1
1     1
1111111